#SWORMS
#this is a comment

# Size in WIDTHxHEIGHT,
SIZE: 40 11

MAP:
AAAAAAAAAAAAAAAAAAAAAAAAAAAAAAAAAAAAAAAA
AAAAAAAAAAAAAAAAAAAAAAAAAAAAAAAAAAAAAAAA
AAAAAAAAAAAEAAAAAEEAAAAAAAAAAAAAAAAAAAAA
AAAAAAAAAAEEEAAAEEEEAAAAAAAAAAAAAAAAAAAA
AAAAAAAAAEEEEEEEEEEEEAAAAAAAAAAAAAAAAAAA
AAAAEAAAEEEEEEEEEEEEEEAAAAAAAAAAAAAAAAAA
AAAEEAAEEEEEEEEEEEEEEEEAAAAAAAAAAAAAAAAA
AAEEEAEEEEEEEEEEEEEEEEEEAAAAAAAAAAAAAAAA
AEEEEEEEEEEEEEEEEEEEEEEEEAAAAAAAAAAAAAAA
AEEEEEEEEEEEEEEEEEEEEEEEEAAAAAAAAAAAAAAA
WEEEEEEEEEEEEEEEEEEEEEEEEEWWWWWWWWWWWWWW

